Player,Nation,Pos,Squad,defense_Age,defense_Born,defense_90s,defense_Tackles_Tkl,defense_Tackles_TklW,defense_Tackles_Def 3rd,defense_Tackles_Mid 3rd,defense_Tackles_Att 3rd,defense_Challenges_Tkl,defense_Challenges_Att,defense_Challenges_Tkl%,defense_Challenges_Lost,defense_Blocks_Blocks,defense_Blocks_Sh,defense_Blocks_Pass,defense_Int,defense_Tkl+Int,defense_Clr,defense_Err,defense_Matches
Max Aarons,eng ENG,DF,Bournemouth,25-097,2000,1.0,2,2,1,1,0,1,1,100.0,0,3,1,2,1,3,0,0,Matches
Joshua Acheampong,eng ENG,DF,Chelsea,18-341,2006,1.9,2,1,2,0,0,2,2,100.0,0,1,0,1,1,3,2,0,Matches
Tyler Adams,us USA,MF,Bournemouth,26-056,1999,15.3,70,43,22,41,7,31,57,54.4,26,24,6,18,29,99,32,0,Matches
Tosin Adarabioyo,eng ENG,DF,Chelsea,27-199,1997,13.1,14,10,10,4,0,8,12,66.7,4,9,7,2,10,24,58,0,Matches
Simon Adingra,ci CIV,"FW,MF",Brighton,23-100,2002,8.3,14,7,7,5,2,6,18,33.3,12,7,0,7,7,21,4,1,Matches
Emmanuel Agbadou,ci CIV,DF,Wolves,27-298,1997,8.7,18,12,12,6,0,8,13,61.5,5,10,8,2,8,26,56,0,Matches
Asher Agbinone,eng ENG,MF,Crystal Palace,19-195,2005,0.1,2,1,0,2,0,0,0,,0,0,0,0,0,2,0,0,Matches
Ola Aina,ng NGA,DF,Nott'ham Forest,28-185,1996,28.5,53,40,39,13,1,34,58,58.6,24,32,12,20,30,83,95,3,Matches
Rayan Aït-Nouri,dz ALG,DF,Wolves,23-309,2001,28.3,77,47,47,24,6,39,63,61.9,24,38,6,32,21,98,62,1,Matches
Kristoffer Ajer,no NOR,DF,Brentford,26-359,1998,14.4,22,15,12,9,1,12,24,50.0,12,16,3,13,11,33,44,0,Matches
Manuel Akanji,ch SUI,DF,Manchester City,29-266,1995,19.0,15,10,8,4,3,7,12,58.3,5,11,8,3,7,22,55,3,Matches
Nathan Aké,nl NED,DF,Manchester City,30-052,1995,7.5,9,7,7,2,0,4,6,66.7,2,7,2,5,3,12,22,1,Matches
Carlos Alcaraz,ar ARG,MF,Southampton,22-132,2002,0.1,0,0,0,0,0,0,0,,0,0,0,0,1,1,0,0,Matches
Carlos Alcaraz,ar ARG,"MF,FW",Everton,22-132,2002,4.6,11,5,5,3,3,3,8,37.5,5,4,1,3,3,14,5,0,Matches
Trent Alexander-Arnold,eng ENG,DF,Liverpool,26-186,1998,23.8,67,47,41,17,9,46,99,46.5,53,25,8,17,30,97,51,4,Matches
Alisson,br BRA,GK,Liverpool,32-191,1992,20.9,1,0,1,0,0,0,1,0.0,1,0,0,0,0,1,12,1,Matches
Miguel Almirón,py PAR,FW,Newcastle Utd,31-060,1994,1.7,3,2,2,0,1,2,3,66.7,1,2,0,2,0,3,0,0,Matches
Edson Álvarez,mx MEX,MF,West Ham,27-169,1997,18.1,44,23,24,12,8,15,33,45.5,18,21,8,13,16,60,39,1,Matches
Will Alves,eng ENG,FW,Leicester City,20-067,2005,0.0,0,0,0,0,0,0,0,,0,0,0,0,0,0,0,0,Matches
Harry Amass,eng ENG,DF,Manchester Utd,18-026,2007,0.2,2,0,2,0,0,0,1,0.0,1,0,0,0,1,3,1,0,Matches
Samuel Amo-Ameyaw,eng ENG,"FW,DF",Southampton,18-267,2006,0.3,1,0,0,1,0,1,1,100.0,0,0,0,0,0,1,0,0,Matches
Mathis Amougou,fr FRA,MF,Chelsea,19-083,2006,0.1,0,0,0,0,0,0,0,,0,0,0,0,0,0,0,0,Matches
Joachim Andersen,dk DEN,DF,Crystal Palace,28-315,1996,1.0,1,1,1,0,0,1,2,50.0,1,0,0,0,0,1,7,0,Matches
Joachim Andersen,dk DEN,DF,Fulham,28-315,1996,21.7,24,17,18,5,1,13,19,68.4,6,23,18,5,28,52,132,1,Matches
Elliot Anderson,eng ENG,MF,Nott'ham Forest,22-156,2002,23.7,72,48,43,23,6,40,89,44.9,49,39,8,31,24,96,51,3,Matches
André,br BRA,MF,Wolves,23-269,2001,21.2,63,41,27,31,5,28,51,54.9,23,38,8,30,26,89,26,1,Matches
Michail Antonio,jm JAM,FW,West Ham,35-014,1990,9.3,2,2,0,1,1,2,3,66.7,1,6,0,6,0,2,2,0,Matches
Antony,br BRA,"DF,MF",Manchester Utd,25-046,2000,1.6,6,3,4,2,0,2,5,40.0,3,2,0,2,2,8,0,0,Matches
Julian Araujo,mx MEX,DF,Bournemouth,23-241,2001,3.9,7,3,3,4,0,4,10,40.0,6,3,0,3,4,11,13,0,Matches
Cameron Archer,eng ENG,FW,Southampton,23-264,2001,13.9,11,7,6,3,2,2,8,25.0,6,5,1,4,2,13,7,0,Matches
Alphonse Areola,fr FRA,GK,West Ham,32-043,1993,19.1,2,2,2,0,0,2,3,66.7,1,0,0,0,0,2,13,2,Matches
Joe Aribo,ng NGA,"MF,DF",Southampton,28-264,1996,21.2,44,30,15,23,6,17,34,50.0,17,24,9,15,20,64,29,3,Matches
Adam Armstrong,eng ENG,"FW,MF",Southampton,28-060,1997,13.9,12,3,2,7,3,3,14,21.4,11,6,1,5,3,15,8,0,Matches
Harrison Armstrong,eng ENG,MF,Everton,18-082,2007,0.5,0,0,0,0,0,0,1,0.0,1,0,0,0,0,0,1,0,Matches
Kepa Arrizabalaga,es ESP,GK,Bournemouth,30-190,1994,24.0,1,0,1,0,0,0,1,0.0,1,1,0,1,0,1,11,3,Matches
Marco Asensio,es ESP,"MF,FW",Aston Villa,29-080,1996,3.4,3,2,0,3,0,2,6,33.3,4,1,0,1,1,4,2,0,Matches
Brandon Austin,eng ENG,GK,Tottenham,26-093,1999,1.0,0,0,0,0,0,0,0,,0,0,0,0,0,0,1,0,Matches
Taiwo Awoniyi,ng NGA,FW,Nott'ham Forest,27-242,1997,4.0,6,3,0,3,3,4,5,80.0,1,1,0,1,0,6,5,0,Matches
Yasin Ayari,se SWE,MF,Brighton,21-187,2003,17.1,48,26,13,25,10,19,44,43.2,25,20,6,14,17,65,20,0,Matches
Jordan Ayew,gh GHA,"FW,MF",Crystal Palace,33-212,1991,0.2,1,0,0,0,1,0,0,,0,0,0,0,0,1,0,0,Matches
Jordan Ayew,gh GHA,"FW,MF",Leicester City,33-212,1991,14.6,24,13,7,12,5,6,19,31.6,13,14,0,14,12,36,16,0,Matches
Benoît Badiashile,fr FRA,DF,Chelsea,24-016,2001,3.7,9,6,5,4,0,4,5,80.0,1,2,2,0,6,15,12,2,Matches
Leon Bailey,jm JAM,"FW,MF",Aston Villa,27-245,1997,12.6,6,4,1,3,2,2,10,20.0,8,6,0,6,3,9,12,0,Matches
Carlos Baleba,cm CMR,MF,Brighton,21-098,2004,22.9,61,32,19,29,13,38,62,61.3,24,35,6,29,39,100,27,1,Matches
Ross Barkley,eng ENG,MF,Aston Villa,31-127,1993,6.2,13,3,4,9,0,9,13,69.2,4,9,3,6,9,22,5,0,Matches
Harvey Barnes,eng ENG,FW,Newcastle Utd,27-123,1997,12.0,13,8,3,4,6,3,6,50.0,3,6,1,5,6,19,9,1,Matches
Calvin Bassey,ng NGA,DF,Fulham,25-101,1999,28.2,47,29,29,18,0,19,26,73.1,7,36,17,19,16,63,89,7,Matches
Jan Bednarek,pl POL,DF,Southampton,28-364,1996,23.1,33,18,20,13,0,15,30,50.0,15,40,30,10,51,84,150,5,Matches
Armel Bella Kotchap,de GER,DF,Southampton,23-121,2001,3.7,7,5,5,2,0,3,6,50.0,3,2,2,0,5,12,21,1,Matches
Jean-Ricner Bellegarde,fr FRA,"MF,FW",Wolves,26-288,1998,16.0,30,16,13,14,3,10,15,66.7,5,17,3,14,10,40,13,1,Matches
Rodrigo Bentancur,uy URU,MF,Tottenham,27-290,1997,15.5,35,17,16,17,2,18,34,52.9,16,23,8,15,33,68,31,1,Matches
Sander Berge,no NOR,MF,Fulham,27-056,1998,20.3,48,28,22,22,4,25,35,71.4,10,24,8,16,19,67,30,1,Matches
Lucas Bergvall,se SWE,MF,Tottenham,19-068,2006,12.0,36,19,12,19,5,17,29,58.6,12,16,7,9,22,58,20,2,Matches
Victor Bernth Kristiansen,dk DEN,DF,Leicester City,22-116,2002,26.4,85,50,54,26,5,47,87,54.0,40,37,14,23,40,125,72,3,Matches
Beto,gw GNB,FW,Everton,27-070,1998,11.9,12,6,2,6,4,5,7,71.4,2,5,1,4,3,15,17,0,Matches
Philip Billing,dk DEN,MF,Bournemouth,28-304,1996,2.0,14,5,7,6,1,3,4,75.0,1,3,0,3,5,19,2,0,Matches
Yves Bissouma,ml MLI,MF,Tottenham,28-224,1996,12.8,41,27,16,22,3,16,30,53.3,14,7,4,3,14,55,31,4,Matches
Oscar Bobb,no NOR,FW,Manchester City,21-273,2003,0.1,0,0,0,0,0,0,0,,0,0,0,0,0,0,0,0,Matches
Lamare Bogarde,nl NED,"DF,MF",Aston Villa,21-096,2004,5.3,14,6,6,6,2,10,16,62.5,6,5,3,2,1,15,13,0,Matches
Willy Boly,ci CIV,DF,Nott'ham Forest,34-067,1991,1.7,6,1,5,1,0,4,4,100.0,0,4,2,2,3,9,12,0,Matches
Sven Botman,nl NED,DF,Newcastle Utd,25-089,2000,2.5,5,3,2,3,0,2,3,66.7,1,2,1,1,4,9,12,0,Matches
Jarrod Bowen,eng ENG,"FW,MF",West Ham,28-112,1996,26.3,35,23,12,9,14,17,37,45.9,20,20,3,17,15,50,21,0,Matches
Conor Bradley,nir NIR,DF,Liverpool,21-276,2003,4.4,7,4,4,2,1,6,13,46.2,7,3,0,3,3,10,18,0,Matches
Jarrad Branthwaite,eng ENG,DF,Everton,22-288,2002,22.1,32,18,25,7,0,17,24,70.8,7,26,18,8,23,55,160,3,Matches
James Bree,eng ENG,DF,Southampton,27-182,1997,9.9,15,10,5,9,1,7,17,41.2,10,8,3,5,8,23,24,0,Matches
Ben Brereton,cl CHI,FW,Southampton,25-358,1999,5.0,3,2,0,2,1,1,9,11.1,8,2,1,1,0,3,4,0,Matches
Nathan Broadhead,wls WAL,"MF,FW",Ipswich Town,27-006,1998,6.6,7,3,2,5,0,3,9,33.3,6,6,1,5,4,11,5,0,Matches
Armando Broja,al ALB,FW,Everton,23-213,2001,2.3,2,1,1,1,0,0,0,,0,3,0,3,0,2,4,0,Matches
David Brooks,wls WAL,"FW,MF",Bournemouth,27-277,1997,8.8,11,4,2,6,3,1,13,7.7,12,16,2,14,5,16,7,1,Matches
Emi Buendía,ar ARG,"MF,FW",Aston Villa,28-107,1996,1.1,6,6,3,2,1,0,5,0.0,5,5,1,4,0,6,2,0,Matches
Santiago Bueno,uy URU,DF,Wolves,26-153,1998,17.1,32,16,21,10,1,13,17,76.5,4,32,18,14,14,46,57,0,Matches
Facundo Buonanotte,ar ARG,"FW,MF",Leicester City,20-109,2004,15.5,48,27,15,19,14,20,63,31.7,43,32,6,26,10,58,12,0,Matches
Cameron Burgess,au AUS,DF,Ipswich Town,29-172,1995,12.5,10,7,8,2,0,6,7,85.7,1,14,11,3,10,20,90,1,Matches
Dan Burn,eng ENG,DF,Newcastle Utd,32-337,1992,29.0,31,17,19,11,1,16,31,51.6,15,30,22,8,19,50,152,3,Matches
Wes Burns,wls WAL,"FW,DF",Ipswich Town,30-139,1994,10.3,13,11,1,9,3,4,10,40.0,6,7,2,5,10,23,13,2,Matches
Moisés Caicedo,ec ECU,MF,Chelsea,23-160,2001,30.2,91,57,35,43,13,44,70,62.9,26,41,9,32,42,133,43,0,Matches
Tom Cairney,sct SCO,MF,Fulham,34-081,1991,4.9,10,5,4,2,4,4,7,57.1,3,4,1,3,4,14,1,1,Matches
Jens Cajuste,se SWE,MF,Ipswich Town,25-244,1999,17.8,37,18,16,20,1,18,44,40.9,26,19,5,14,21,58,27,2,Matches
Riccardo Calafiori,it ITA,DF,Arsenal,22-327,2002,10.3,26,18,15,9,2,18,29,62.1,11,12,6,6,9,35,25,0,Matches
Dominic Calvert-Lewin,eng ENG,FW,Everton,28-026,1997,17.5,9,7,1,4,4,2,6,33.3,4,6,2,4,6,15,18,0,Matches
Diego Carlos,br BRA,DF,Aston Villa,32-027,1993,9.2,8,3,6,1,1,4,6,66.7,2,13,7,6,5,13,36,2,Matches
Fabio Carvalho,pt POR,"FW,MF",Brentford,22-224,2002,5.1,13,9,4,4,5,6,13,46.2,7,6,1,5,3,16,2,0,Matches
Casemiro,br BRA,MF,Manchester Utd,33-047,1992,14.1,74,43,43,22,9,39,64,60.9,25,33,10,23,12,86,46,3,Matches
Kaelan Casey,eng ENG,DF,West Ham,20-165,2004,0.0,0,0,0,0,0,0,0,,0,0,0,0,0,0,1,0,Matches
Matty Cash,pl POL,DF,Aston Villa,27-247,1997,16.4,41,23,23,16,2,19,29,65.5,10,16,5,11,20,61,44,2,Matches
Eiran Cashin,ie IRL,DF,Brighton,23-153,2001,0.2,0,0,0,0,0,0,1,0.0,1,0,0,0,0,0,2,0,Matches
Timothy Castagne,be BEL,DF,Fulham,29-127,1995,16.9,45,28,27,15,3,26,44,59.1,18,13,4,9,20,65,77,0,Matches
Trevoh Chalobah,eng ENG,DF,Crystal Palace,25-280,1999,11.8,20,16,7,12,1,12,23,52.2,11,19,9,10,19,39,57,3,Matches
Trevoh Chalobah,eng ENG,DF,Chelsea,25-280,1999,5.3,4,1,1,3,0,3,3,100.0,0,3,1,2,7,11,22,1,Matches
Conor Chaplin,eng ENG,"MF,FW",Ipswich Town,28-054,1997,6.9,12,5,4,6,2,6,13,46.2,7,8,1,7,3,15,2,0,Matches
Youssef Chermiti,pt POR,"FW,MF",Everton,20-322,2004,0.2,0,0,0,0,0,0,0,,0,0,0,0,0,0,0,0,Matches
Federico Chiesa,it ITA,FW,Liverpool,27-168,1997,0.4,0,0,0,0,0,0,2,0.0,2,1,0,1,0,0,0,0,Matches
Ben Chilwell,eng ENG,DF,Crystal Palace,28-111,1996,1.2,4,4,2,2,0,0,2,0.0,2,3,1,2,1,5,11,0,Matches
Chiquinho,pt POR,MF,Wolves,25-065,2000,0.1,0,0,0,0,0,0,0,,0,0,0,0,0,0,0,0,Matches
Hamza Choudhury,bd BAN,"MF,DF",Leicester City,27-192,1997,1.5,1,1,1,0,0,1,3,33.3,2,4,2,2,5,6,2,0,Matches
Ryan Christie,sct SCO,MF,Bournemouth,30-048,1995,23.5,54,33,19,27,8,27,64,42.2,37,44,11,33,30,84,51,3,Matches
Harry Clarke,eng ENG,DF,Ipswich Town,24-040,2001,4.2,5,3,3,2,0,3,6,50.0,3,5,4,1,4,9,14,3,Matches
Jack Clarke,eng ENG,"FW,MF",Ipswich Town,24-139,2000,9.9,27,16,10,9,8,15,30,50.0,15,5,0,5,5,32,16,1,Matches
Nathaniel Clyne,eng ENG,"DF,MF",Crystal Palace,34-006,1991,5.1,12,8,8,3,1,6,10,60.0,4,4,2,2,3,15,13,1,Matches
Conor Coady,eng ENG,DF,Leicester City,32-045,1993,12.0,11,8,5,5,1,2,4,50.0,2,21,16,5,11,22,43,2,Matches
Séamus Coleman,ie IRL,DF,Everton,36-182,1988,2.2,2,1,1,1,0,2,3,66.7,1,5,3,2,1,3,7,0,Matches
Nathan Collins,ie IRL,DF,Brentford,23-346,2001,31.0,34,20,21,9,4,20,30,66.7,10,66,47,19,29,63,186,2,Matches
Toby Collyer,eng ENG,MF,Manchester Utd,21-098,2004,2.0,12,9,6,6,0,5,6,83.3,1,2,1,1,2,14,3,0,Matches
Levi Colwill,eng ENG,DF,Chelsea,22-044,2003,28.0,34,23,17,15,2,15,24,62.5,9,30,22,8,28,62,93,4,Matches
Lewis Cook,eng ENG,"MF,DF",Bournemouth,28-067,1997,28.6,70,39,36,32,2,33,61,54.1,28,26,8,18,39,109,57,0,Matches
Maxwel Cornet,ci CIV,FW,Southampton,28-196,1996,0.8,5,5,1,4,0,0,4,0.0,4,0,0,0,0,5,2,0,Matches
Vladimír Coufal,cz CZE,DF,West Ham,32-232,1992,8.2,14,9,9,4,1,6,15,40.0,9,11,10,1,6,20,29,1,Matches
Woyo Coulibaly,fr FRA,DF,Leicester City,25-326,1999,1.2,6,4,4,2,0,2,2,100.0,0,3,1,2,5,11,1,0,Matches
Aaron Cresswell,eng ENG,DF,West Ham,35-117,1989,6.5,8,4,3,4,1,6,8,75.0,2,7,4,3,6,14,30,0,Matches
Marc Cucurella,es ESP,DF,Chelsea,26-263,1998,26.2,52,35,27,20,5,24,46,52.2,22,38,11,27,20,72,67,3,Matches
Jorge Cuenca,es ESP,DF,Fulham,25-145,1999,2.9,2,2,2,0,0,2,5,40.0,3,3,3,0,2,4,21,0,Matches
Matheus Cunha,br BRA,"MF,FW",Wolves,25-319,1999,23.8,32,18,16,13,3,11,34,32.4,23,17,1,16,16,48,22,0,Matches
Patson Daka,zm ZAM,"FW,MF",Leicester City,26-184,1998,6.5,14,7,3,7,4,7,17,41.2,10,6,1,5,1,15,8,0,Matches
Diogo Dalot,pt POR,DF,Manchester Utd,26-024,1999,29.6,62,35,37,20,5,30,47,63.8,17,20,9,11,36,98,71,0,Matches
Mikkel Damsgaard,dk DEN,"MF,FW",Brentford,24-282,2000,25.9,72,40,27,22,23,27,66,40.9,39,32,2,30,22,94,27,2,Matches
Danilo,br BRA,"MF,FW",Nott'ham Forest,23-347,2001,2.3,2,1,1,1,0,1,3,33.3,2,1,1,0,1,3,2,0,Matches
Jayden Danns,eng ENG,MF,Liverpool,19-085,2006,0.1,0,0,0,0,0,0,1,0.0,1,0,0,0,0,0,0,0,Matches
Kevin Danso,at AUT,DF,Tottenham,26-204,1998,3.9,5,4,2,3,0,4,6,66.7,2,4,4,0,2,7,22,1,Matches
Ben Davies,wls WAL,DF,Tottenham,31-352,1993,9.0,9,5,4,5,0,5,10,50.0,5,16,11,5,9,18,53,1,Matches
Leif Davis,eng ENG,DF,Ipswich Town,25-089,2000,27.5,45,26,32,9,4,29,46,63.0,17,22,7,15,23,68,68,3,Matches
Craig Dawson,eng ENG,DF,Wolves,34-340,1990,10.8,15,3,8,6,1,12,15,80.0,3,16,11,5,9,24,52,1,Matches
Kevin De Bruyne,be BEL,MF,Manchester City,33-287,1991,13.3,11,5,4,4,3,3,16,18.8,13,6,0,6,5,16,9,1,Matches
Liam Delap,eng ENG,FW,Ipswich Town,22-062,2003,25.8,10,7,3,2,5,2,14,14.3,12,8,0,8,2,12,26,0,Matches
Sepp van den Berg,nl NED,DF,Brentford,23-112,2001,21.7,31,18,19,8,4,14,23,60.9,9,45,31,14,18,49,100,2,Matches
Justin Devenny,nir NIR,MF,Crystal Palace,21-182,2003,3.7,11,8,6,4,1,7,13,53.8,6,3,0,3,0,11,10,0,Matches
Kiernan Dewsbury-Hall,eng ENG,"MF,FW",Chelsea,26-217,1998,2.9,8,5,1,1,6,4,6,66.7,2,2,0,2,1,9,8,1,Matches
Amad Diallo,ci CIV,"FW,MF",Manchester Utd,22-274,2002,17.7,33,26,6,19,8,15,26,57.7,11,10,0,10,11,44,16,0,Matches
Rúben Dias,pt POR,DF,Manchester City,27-332,1997,18.2,13,7,5,7,1,5,8,62.5,3,14,12,2,17,30,46,3,Matches
Luis Díaz,co COL,FW,Liverpool,28-088,1997,21.9,28,18,8,14,6,11,31,35.5,20,14,0,14,6,34,7,1,Matches
Tyler Dibling,eng ENG,"FW,MF",Southampton,19-030,2006,18.0,34,20,13,18,3,16,26,61.5,10,17,5,12,7,41,9,1,Matches
Lucas Digne,fr FRA,DF,Aston Villa,31-265,1993,23.9,60,34,36,15,9,40,58,69.0,18,23,4,19,25,85,77,1,Matches
Issa Diop,fr FRA,DF,Fulham,28-092,1997,14.9,26,12,18,8,0,13,18,72.2,5,10,7,3,9,35,72,2,Matches
Axel Disasi,fr FRA,DF,Aston Villa,27-031,1998,5.1,6,4,5,1,0,1,3,33.3,2,4,1,3,5,11,18,0,Matches
Axel Disasi,fr FRA,DF,Chelsea,27-031,1998,4.0,7,4,5,1,1,6,11,54.5,5,4,1,3,2,9,11,1,Matches
Roman Dixon,eng ENG,DF,Everton,20-106,2004,1.0,5,5,3,2,0,4,4,100.0,0,1,0,1,1,6,3,0,Matches
Nasser Djiga,bf BFA,DF,Wolves,22-147,2002,0.2,0,0,0,0,0,0,0,,0,0,0,0,2,2,3,1,Matches
Matt Doherty,ie IRL,DF,Wolves,33-085,1992,19.6,35,19,23,12,0,14,21,66.7,7,23,14,9,21,56,83,3,Matches
Jeremy Doku,be BEL,"FW,MF",Manchester City,22-319,2002,14.1,27,19,9,12,6,7,13,53.8,6,10,1,9,4,31,2,0,Matches
Nicolás Domínguez,ar ARG,"MF,FW",Nott'ham Forest,26-287,1998,16.6,69,36,32,27,10,27,58,46.6,31,30,10,20,25,94,38,1,Matches
Patrick Dorgu,dk DEN,DF,Manchester Utd,20-167,2004,4.5,12,7,7,5,0,9,10,90.0,1,8,0,8,1,13,11,1,Matches
Alfie Dorrington,eng ENG,DF,Tottenham,19-356,2005,0.2,0,0,0,0,0,0,0,,0,0,0,0,0,0,0,0,Matches
Abdoulaye Doucouré,ml MLI,MF,Everton,32-100,1993,23.9,41,24,19,16,6,11,32,34.4,21,29,6,23,7,48,18,1,Matches
Cheick Doucouré,ml MLI,MF,Crystal Palace,25-093,2000,5.0,16,8,6,8,2,5,11,45.5,6,4,0,4,11,27,10,1,Matches
Flynn Downes,eng ENG,MF,Southampton,26-081,1999,17.9,40,21,18,18,4,13,31,41.9,18,20,4,16,29,69,34,4,Matches
Tommy Doyle,eng ENG,MF,Wolves,23-176,2001,5.4,11,6,6,3,2,6,15,40.0,9,11,5,6,5,16,11,1,Matches
Radu Drăgușin,ro ROU,DF,Tottenham,23-067,2002,13.9,10,6,8,2,0,6,12,50.0,6,22,16,6,15,25,49,4,Matches
Martin Dúbravka,sk SVK,GK,Newcastle Utd,36-086,1989,10.0,0,0,0,0,0,0,0,,0,0,0,0,0,0,3,0,Matches
Lewis Dunk,eng ENG,DF,Brighton,33-141,1991,19.1,16,9,8,6,2,10,15,66.7,5,20,14,6,11,27,60,0,Matches
Jáder Durán,co COL,FW,Aston Villa,21-119,2003,7.1,8,7,1,2,5,1,4,25.0,3,5,0,5,0,8,13,0,Matches
Ederson,br BRA,GK,Manchester City,31-237,1993,21.0,0,0,0,0,0,0,2,0.0,2,0,0,0,1,1,9,2,Matches
George Edmundson,eng ENG,DF,Ipswich Town,27-223,1997,0.0,0,0,0,0,0,0,0,,0,0,0,0,0,0,0,0,Matches
Odsonne Édouard,fr FRA,"MF,FW",Crystal Palace,27-085,1998,1.3,1,0,0,1,0,0,2,0.0,2,1,0,1,0,1,1,0,Matches
Odsonne Édouard,fr FRA,FW,Leicester City,27-085,1998,0.3,1,1,1,0,0,0,0,,0,0,0,0,0,1,1,0,Matches
Samuel Edozie,eng ENG,"DF,FW",Southampton,22-073,2003,0.7,3,1,0,1,2,2,2,100.0,0,0,0,0,0,3,0,0,Matches
Ronnie Edwards,eng ENG,DF,Southampton,22-014,2003,0.1,0,0,0,0,0,0,0,,0,1,1,0,0,0,0,0,Matches
Anthony Elanga,se SWE,FW,Nott'ham Forest,22-349,2002,21.9,17,12,7,8,2,4,15,26.7,11,9,1,8,5,22,25,0,Matches
Harvey Elliott,eng ENG,"MF,FW",Liverpool,22-007,2003,1.8,3,2,2,1,0,0,3,0.0,3,3,1,2,0,3,2,0,Matches
Yunus Emre Konak,tr TUR,"FW,MF",Brentford,19-091,2006,0.3,4,4,0,4,0,1,2,50.0,1,0,0,0,0,4,0,0,Matches
Julio Enciso,py PAR,"FW,MF",Ipswich Town,21-078,2004,4.8,5,3,2,1,2,2,3,66.7,1,2,0,2,1,6,1,0,Matches
Julio Enciso,py PAR,"MF,FW",Brighton,21-078,2004,3.3,0,0,0,0,0,0,2,0.0,2,2,0,2,0,0,1,0,Matches
Wataru Endo,jp JPN,MF,Liverpool,32-061,1993,1.6,8,6,4,4,0,5,8,62.5,3,3,0,3,3,11,5,0,Matches
Christian Eriksen,dk DEN,MF,Manchester Utd,33-056,1992,9.0,13,5,3,8,2,7,16,43.8,9,10,4,6,7,20,6,0,Matches
Romain Esse,eng ENG,MF,Crystal Palace,19-333,2005,0.1,1,1,1,0,0,1,1,100.0,0,0,0,0,0,1,0,0,Matches
Pervis Estupiñán,ec ECU,DF,Brighton,27-080,1998,20.7,47,31,26,15,6,23,35,65.7,12,12,2,10,25,72,46,1,Matches
Evanilson,br BRA,FW,Bournemouth,25-187,1999,19.1,11,6,4,4,3,5,9,55.6,4,8,1,7,0,11,14,0,Matches
Jonny Evans,nir NIR,DF,Manchester Utd,37-098,1988,3.2,7,5,4,3,0,2,4,50.0,2,2,1,1,4,11,13,0,Matches
Eberechi Eze,eng ENG,"MF,FW",Crystal Palace,26-286,1998,23.3,36,22,13,14,9,17,35,48.6,18,24,0,24,10,46,9,3,Matches
Łukasz Fabiański,pl POL,GK,West Ham,39-358,1985,11.9,0,0,0,0,0,0,1,0.0,1,0,0,0,0,0,5,1,Matches
Wout Faes,be BEL,DF,Leicester City,27-008,1998,25.3,38,23,25,11,2,22,41,53.7,19,42,30,12,25,63,146,3,Matches
Abdul Fatawu Issahaku,gh GHA,FW,Leicester City,21-034,2004,6.4,21,15,13,2,6,11,19,57.9,8,7,0,7,4,25,12,0,Matches
João Félix,pt POR,"FW,MF",Chelsea,25-152,1999,4.1,8,3,2,5,1,5,9,55.6,4,2,0,2,3,11,2,0,Matches
Evan Ferguson,ie IRL,FW,West Ham,20-174,2004,1.6,2,0,0,1,1,0,0,,0,2,1,1,1,3,1,0,Matches
Evan Ferguson,ie IRL,FW,Brighton,20-174,2004,2.7,4,3,0,3,1,2,5,40.0,3,3,1,2,0,4,4,0,Matches
Bruno Fernandes,pt POR,MF,Manchester Utd,30-215,1994,28.4,70,42,21,35,14,27,70,38.6,43,28,4,24,23,93,33,2,Matches
Mateus Fernandes,pt POR,MF,Southampton,20-275,2004,25.8,75,41,38,23,14,27,57,47.4,30,33,3,30,18,93,26,5,Matches
Enzo Fernández,ar ARG,MF,Chelsea,24-084,2001,25.8,55,28,14,26,15,26,70,37.1,44,30,5,25,11,66,19,4,Matches
Mark Flekken,nl NED,GK,Brentford,31-302,1993,29.4,3,3,3,0,0,2,7,28.6,5,1,0,1,0,3,24,3,Matches
Phil Foden,eng ENG,"MF,FW",Manchester City,24-318,2000,18.7,12,5,5,4,3,7,17,41.2,10,12,1,11,9,21,7,1,Matches
Wesley Fofana,fr FRA,DF,Chelsea,24-115,2000,13.0,13,12,6,7,0,6,14,42.9,8,14,9,5,14,27,55,2,Matches
Carlos Forbs,pt POR,"MF,FW",Wolves,21-023,2004,2.6,8,5,5,2,1,4,5,80.0,1,3,0,3,1,9,2,1,Matches
Fraser Forster,eng ENG,GK,Tottenham,37-025,1988,7.0,0,0,0,0,0,0,1,0.0,1,0,0,0,0,0,7,3,Matches
Matheus França,br BRA,"MF,DF",Crystal Palace,21-010,2004,0.2,0,0,0,0,0,0,0,,0,0,0,0,0,0,0,0,Matches
Ryan Fraser,sct SCO,"FW,DF",Southampton,31-046,1994,3.4,6,2,2,4,0,4,6,66.7,2,1,1,0,1,7,9,0,Matches
Niclas Füllkrug,de GER,FW,West Ham,32-061,1993,5.0,2,2,0,1,1,2,3,66.7,1,1,0,1,0,2,8,0,Matches
Cody Gakpo,nl NED,FW,Liverpool,25-339,1999,16.3,24,12,5,10,9,11,21,52.4,10,17,2,15,8,32,15,1,Matches
Idrissa Gana Gueye,sn SEN,MF,Everton,35-197,1989,27.2,115,69,55,45,15,51,82,62.2,31,41,8,33,37,152,26,1,Matches
Andrés García,es ESP,"DF,MF",Aston Villa,22-063,2003,3.5,9,5,5,3,1,4,8,50.0,4,2,0,2,2,11,8,2,Matches
Alejandro Garnacho,ar ARG,"MF,FW",Manchester Utd,20-284,2004,20.2,26,17,9,6,11,10,28,35.7,18,16,0,16,10,36,10,2,Matches
James Garner,eng ENG,"MF,DF",Everton,24-029,2001,10.7,25,15,14,9,2,12,27,44.4,15,13,3,10,14,39,28,0,Matches
Tyrique George,eng ENG,FW,Chelsea,19-066,2006,1.0,2,0,2,0,0,2,3,66.7,1,0,0,0,1,3,0,0,Matches
Morgan Gibbs-White,eng ENG,MF,Nott'ham Forest,25-074,2000,24.4,37,17,14,17,6,13,26,50.0,13,13,4,9,17,54,21,1,Matches
Billy Gilmour,sct SCO,MF,Brighton,23-304,2001,1.1,3,3,2,1,0,3,4,75.0,1,1,0,1,0,3,1,0,Matches
Ben Godfrey,eng ENG,DF,Ipswich Town,27-086,1998,1.2,0,0,0,0,0,0,0,,0,1,1,0,2,2,1,0,Matches
Martial Godo,eng ENG,FW,Fulham,22-028,2003,0.2,0,0,0,0,0,0,0,,0,1,0,1,1,1,0,0,Matches
João Gomes,br BRA,MF,Wolves,24-058,2001,27.0,88,52,43,42,3,35,86,40.7,51,36,3,33,25,113,29,0,Matches
Rodrigo Gomes,pt POR,"DF,FW",Wolves,21-278,2003,6.6,19,12,10,9,0,9,17,52.9,8,8,1,7,5,24,17,1,Matches
Toti Gomes,pt POR,DF,Wolves,26-085,1999,22.0,47,34,31,14,2,25,31,80.6,6,24,14,10,19,66,117,5,Matches
Diego Gómez,py PAR,MF,Brighton,22-015,2003,4.4,16,10,8,7,1,9,18,50.0,9,9,0,9,6,22,9,1,Matches
Joe Gomez,eng ENG,DF,Liverpool,27-323,1997,5.8,13,10,5,7,1,11,16,68.8,5,9,6,3,7,20,20,2,Matches
Nicolás González,es ESP,MF,Manchester City,23-098,2002,5.3,9,3,4,4,1,2,5,40.0,3,9,0,9,3,12,14,0,Matches
Anthony Gordon,eng ENG,FW,Newcastle Utd,24-046,2001,23.4,28,17,9,16,3,11,32,34.4,21,24,2,22,6,34,9,2,Matches
Ryan Gravenberch,nl NED,MF,Liverpool,22-330,2002,29.5,56,28,22,24,10,27,45,60.0,18,32,9,23,53,109,53,0,Matches
Archie Gray,eng ENG,"DF,MF",Tottenham,19-030,2006,14.0,12,6,3,6,3,6,16,37.5,10,19,10,9,8,20,39,2,Matches
Jack Grealish,eng ENG,"FW,MF",Manchester City,29-213,1995,8.0,9,5,4,2,3,2,5,40.0,3,11,2,9,2,11,5,1,Matches
Jacob Greaves,eng ENG,DF,Ipswich Town,24-211,2000,18.5,27,13,11,15,1,14,22,63.6,8,27,19,8,17,44,104,2,Matches
Brajan Gruda,de GER,"FW,MF",Brighton,20-315,2004,5.4,13,5,5,5,3,7,14,50.0,7,8,0,8,2,15,4,0,Matches
Albert Grønbaek,dk DEN,"FW,MF",Southampton,23-323,2001,1.6,4,1,1,1,2,3,10,30.0,7,1,1,0,0,4,1,0,Matches
Gonçalo Guedes,pt POR,"MF,FW",Wolves,28-133,1996,8.6,14,4,2,5,7,3,15,20.0,12,9,0,9,5,19,3,0,Matches
Marc Guéhi,eng ENG,DF,Crystal Palace,24-272,2000,29.0,53,29,31,20,2,29,42,69.0,13,50,21,29,23,76,139,2,Matches
Luis Guilherme,br BRA,"MF,FW",West Ham,19-061,2006,1.2,1,0,1,0,0,0,1,0.0,1,6,0,6,3,4,2,0,Matches
Bruno Guimarães,br BRA,MF,Newcastle Utd,27-146,1997,28.6,65,39,33,23,9,29,59,49.2,30,31,9,22,25,90,34,3,Matches
Marc Guiu,es ESP,FW,Chelsea,19-097,2006,0.8,1,1,0,1,0,1,1,100.0,0,0,0,0,0,1,0,0,Matches
İlkay Gündoğan,de GER,MF,Manchester City,34-169,1990,18.9,22,13,4,13,5,10,23,43.5,13,11,0,11,12,34,19,0,Matches
Malo Gusto,fr FRA,DF,Chelsea,21-327,2003,19.2,43,28,26,15,2,24,45,53.3,21,28,8,20,22,65,45,5,Matches
Joško Gvardiol,hr CRO,DF,Manchester City,23-078,2002,29.4,49,33,24,15,10,19,34,55.9,15,35,17,18,31,80,101,8,Matches
Erling Haaland,no NOR,FW,Manchester City,24-264,2000,27.6,9,5,3,3,3,2,6,33.3,4,11,1,10,5,14,23,0,Matches
Lewis Hall,eng ENG,DF,Newcastle Utd,20-215,2004,24.3,58,41,28,22,8,40,74,54.1,34,33,18,15,18,76,75,3,Matches
Ali Al Hamadi,iq IRQ,FW,Ipswich Town,23-041,2002,1.5,1,0,0,0,1,0,2,0.0,2,0,0,0,0,1,2,0,Matches
Marcus Harness,eng ENG,MF,Ipswich Town,29-046,1996,0.5,1,0,0,0,1,0,3,0.0,3,2,1,1,0,1,1,0,Matches
Jack Harrison,eng ENG,FW,Everton,28-142,1996,18.4,27,19,12,8,7,14,35,40.0,21,15,2,13,7,34,31,2,Matches
Taylor Harwood-Bellis,eng ENG,DF,Southampton,23-071,2002,25.6,27,19,13,11,3,19,29,65.5,10,55,34,21,28,55,110,6,Matches
Kai Havertz,de GER,"FW,MF",Arsenal,25-304,1999,20.4,16,9,3,6,7,4,15,26.7,11,22,4,18,6,22,31,1,Matches
Ayden Heaven,eng ENG,DF,Manchester Utd,18-201,2006,1.1,3,3,1,2,0,2,2,100.0,0,2,2,0,1,4,6,0,Matches
Jan Paul van Hecke,nl NED,DF,Brighton,24-307,2000,27.9,38,25,19,18,1,19,36,52.8,17,32,19,13,22,60,123,2,Matches
Hwang Hee-chan,kr KOR,"MF,FW",Wolves,29-075,1996,7.1,6,4,2,1,3,2,6,33.3,4,9,0,9,2,8,11,0,Matches
Dean Henderson,eng ENG,GK,Crystal Palace,28-030,1997,30.0,2,1,2,0,0,2,5,40.0,3,0,0,0,0,2,21,0,Matches
Rico Henry,eng ENG,DF,Brentford,27-277,1997,0.0,0,0,0,0,0,0,1,0.0,1,0,0,0,1,1,0,0,Matches
Mads Hermansen,dk DEN,GK,Leicester City,24-274,2000,23.5,1,1,1,0,0,1,1,100.0,0,1,0,1,0,1,9,3,Matches
Son Heung-min,kr KOR,FW,Tottenham,32-277,1992,22.3,17,9,3,8,6,5,23,21.7,18,10,0,10,5,22,16,1,Matches
James Hill,eng ENG,DF,Bournemouth,23-091,2002,5.0,15,8,6,6,3,3,11,27.3,8,5,0,5,9,24,31,0,Matches
Jack Hinshelwood,eng ENG,"DF,MF",Brighton,20-000,2005,15.7,23,16,7,9,7,9,21,42.9,12,6,3,3,14,37,32,1,Matches
George Hirst,sct SCO,FW,Ipswich Town,26-055,1999,3.3,2,2,1,0,1,1,2,50.0,1,0,0,0,1,3,6,0,Matches
Mason Holgate,eng ENG,"FW,DF",Everton,28-171,1996,0.1,0,0,0,0,0,0,0,,0,0,0,0,0,0,0,0,Matches
Callum Hudson-Odoi,eng ENG,FW,Nott'ham Forest,24-155,2000,22.0,17,12,6,7,4,8,13,61.5,5,10,0,10,13,30,10,1,Matches
Will Hughes,eng ENG,MF,Crystal Palace,29-359,1995,18.3,61,33,17,31,13,27,58,46.6,31,27,12,15,16,77,19,1,Matches
Dean Huijsen,es ESP,DF,Bournemouth,19-362,2005,20.8,31,21,15,15,1,15,25,60.0,10,32,24,8,45,76,143,3,Matches
Omari Hutchinson,eng ENG,"MF,FW",Ipswich Town,21-163,2003,24.7,30,11,14,9,7,13,45,28.9,32,24,1,23,10,40,13,1,Matches
Rasmus Højlund,dk DEN,FW,Manchester Utd,22-066,2003,17.2,3,1,0,2,1,0,4,0.0,4,4,0,4,1,4,5,0,Matches
Igor,br BRA,DF,Brighton,27-063,1998,10.0,4,4,2,1,1,4,10,40.0,6,23,14,9,4,8,39,1,Matches
Danny Ings,eng ENG,"FW,MF",West Ham,32-262,1992,3.2,4,2,2,2,0,1,3,33.3,2,5,0,5,1,5,4,0,Matches
Tim Iroegbunam,eng ENG,MF,Everton,21-285,2003,6.2,26,12,12,9,5,13,20,65.0,7,16,4,12,14,40,11,1,Matches
Andy Irving,sct SCO,MF,West Ham,24-333,2000,1.8,7,4,3,3,1,1,5,20.0,4,5,1,4,1,8,5,0,Matches
Alexander Isak,se SWE,FW,Newcastle Utd,25-202,1999,24.3,12,5,2,3,7,5,12,41.7,7,17,2,15,3,15,15,1,Matches
Alex Iwobi,ng NGA,"FW,MF",Fulham,28-343,1996,27.4,36,20,13,18,5,17,27,63.0,10,22,1,21,10,46,27,0,Matches
Nicolas Jackson,sn SEN,FW,Chelsea,23-295,2001,20.7,17,10,4,5,8,2,7,28.6,5,12,2,10,2,19,15,0,Matches
Reece James,eng ENG,"DF,MF",Chelsea,25-124,1999,8.5,8,8,5,3,0,3,9,33.3,6,11,4,7,11,19,17,3,Matches
Vitaly Janelt,de GER,MF,Brentford,26-336,1998,24.2,36,20,14,13,9,20,35,57.1,15,31,8,23,27,63,51,1,Matches
Vitezslav Jaros,cz CZE,GK,Liverpool,23-262,2001,0.1,0,0,0,0,0,0,0,,0,0,0,0,0,0,0,0,Matches
Daniel Jebbison,eng ENG,FW,Bournemouth,21-241,2003,0.8,2,1,1,1,0,2,4,50.0,2,1,1,0,1,3,1,0,Matches
Mathias Jensen,dk DEN,MF,Brentford,29-100,1996,8.3,11,8,6,4,1,6,12,50.0,6,11,3,8,6,17,10,1,Matches
Gabriel Jesus,br BRA,FW,Arsenal,28-008,1997,6.8,10,6,4,3,3,4,9,44.4,5,10,1,9,4,14,8,0,Matches
Raúl Jiménez,mx MEX,FW,Fulham,33-341,1991,21.4,27,17,6,14,7,6,17,35.3,11,18,5,13,9,36,16,3,Matches
Kim Jisoo,kr KOR,DF,Brentford,20-108,2004,0.3,0,0,0,0,0,0,0,,0,0,0,0,0,0,2,0,Matches
João Pedro,br BRA,"FW,MF",Brighton,23-197,2001,20.0,15,11,5,6,4,3,10,30.0,7,12,0,12,7,22,10,0,Matches
Joelinton,br BRA,"MF,FW",Newcastle Utd,28-240,1996,24.0,55,34,23,22,10,24,42,57.1,18,33,6,27,22,77,46,1,Matches
Ben Johnson,eng ENG,"DF,FW",Ipswich Town,25-077,2000,12.6,32,21,20,9,3,17,38,44.7,21,18,5,13,12,44,46,1,Matches
Brennan Johnson,wls WAL,FW,Tottenham,23-323,2001,20.9,37,24,8,20,9,15,29,51.7,14,21,3,18,4,41,11,0,Matches
Sam Johnstone,eng ENG,GK,Wolves,32-017,1993,7.0,0,0,0,0,0,0,1,0.0,1,0,0,0,0,0,7,0,Matches
Curtis Jones,eng ENG,"MF,DF",Liverpool,24-071,2001,15.0,31,16,4,20,7,12,20,60.0,8,15,7,8,5,36,8,2,Matches
Jorginho,it ITA,MF,Arsenal,33-112,1991,6.8,12,4,1,7,4,8,20,40.0,12,3,0,3,5,17,2,2,Matches
Diogo Jota,pt POR,FW,Liverpool,28-128,1996,10.9,11,7,0,7,4,7,19,36.8,12,9,0,9,6,17,6,0,Matches
James Justin,eng ENG,DF,Leicester City,27-047,1998,27.1,44,27,24,16,4,25,46,54.3,21,38,12,26,41,85,117,3,Matches
Filip Jørgensen,dk DEN,GK,Chelsea,22-360,2002,6.0,0,0,0,0,0,0,0,,0,0,0,0,0,0,0,3,Matches
Ferdi Kadioglu,tr TUR,"DF,MF",Brighton,25-186,1999,4.3,10,6,4,5,1,6,15,40.0,9,2,2,0,8,18,17,0,Matches
Daichi Kamada,jp JPN,MF,Crystal Palace,28-249,1996,12.3,40,23,17,20,3,12,34,35.3,22,16,3,13,15,55,10,0,Matches
Boubacar Kamara,fr FRA,MF,Aston Villa,25-139,1999,13.3,44,18,25,15,4,26,48,54.2,22,15,5,10,14,58,41,3,Matches
Michael Kayode,it ITA,DF,Brentford,20-275,2004,0.5,2,2,2,0,0,1,1,100.0,0,0,0,0,1,3,1,0,Matches
Michael Keane,eng ENG,DF,Everton,32-090,1993,9.0,10,7,7,2,1,7,10,70.0,3,9,6,3,10,20,50,0,Matches
Caoimhín Kelleher,ie IRL,GK,Liverpool,26-139,1998,10.0,0,0,0,0,0,0,0,,0,0,0,0,0,0,1,2,Matches
Lloyd Kelly,eng ENG,DF,Newcastle Utd,26-187,1998,3.4,5,4,4,1,0,1,1,100.0,0,6,4,2,1,6,17,0,Matches
Milos Kerkez,hu HUN,DF,Bournemouth,21-155,2003,30.2,46,25,21,19,6,20,34,58.8,14,32,11,21,38,84,91,2,Matches
Bilal El Khannouss,ma MAR,MF,Leicester City,20-336,2004,18.4,43,23,14,24,5,12,20,60.0,8,17,3,14,5,48,5,3,Matches
Abdukodir Khusanov,uz UZB,DF,Manchester City,21-041,2004,5.6,5,4,4,1,0,2,3,66.7,1,5,4,1,3,8,29,1,Matches
Max Kilman,eng ENG,DF,West Ham,27-323,1997,30.2,27,15,12,12,3,16,20,80.0,4,48,32,16,34,61,161,4,Matches
Joshua King,eng ENG,"MF,FW",Fulham,18-098,2007,0.9,5,3,2,3,0,0,2,0.0,2,2,0,2,1,6,1,0,Matches
Antonín Kinský,cz CZE,GK,Tottenham,22-029,2003,4.0,3,1,3,0,0,1,1,100.0,0,0,0,0,0,3,5,1,Matches
Jakub Kiwior,pl POL,DF,Arsenal,25-055,2000,5.5,8,3,6,2,0,6,9,66.7,3,6,3,3,1,9,24,2,Matches
Justin Kluivert,nl NED,"MF,FW",Bournemouth,25-341,1999,21.5,20,9,4,10,6,4,19,21.1,15,20,0,20,13,33,22,1,Matches
Ibrahima Konaté,fr FRA,DF,Liverpool,25-321,1999,22.8,34,23,24,9,1,22,32,68.8,10,26,15,11,11,45,104,2,Matches
Ezri Konsa,eng ENG,DF,Aston Villa,27-170,1997,25.6,29,17,18,7,4,17,21,81.0,4,16,9,7,19,48,86,2,Matches
Mateo Kovačić,hr CRO,MF,Manchester City,30-340,1994,19.7,58,34,20,31,7,27,55,49.1,28,18,0,18,18,76,20,1,Matches
Caleb Kporha,eng ENG,DF,Crystal Palace,18-270,2006,0.1,2,1,2,0,0,2,2,100.0,0,0,0,0,0,2,1,0,Matches
Emil Krafth,se SWE,DF,Newcastle Utd,30-252,1994,2.8,2,1,0,1,1,1,2,50.0,1,5,4,1,2,4,10,0,Matches
Mohammed Kudus,gh GHA,"FW,MF",West Ham,24-252,2000,23.1,31,19,7,15,9,9,25,36.0,16,21,1,20,4,35,6,2,Matches
Dejan Kulusevski,se SWE,"MF,FW",Tottenham,24-351,2000,23.9,39,22,14,11,14,16,46,34.8,30,25,3,22,11,50,9,1,Matches
Maxence Lacroix,fr FRA,DF,Crystal Palace,25-005,2000,26.9,62,37,46,15,1,29,42,69.0,13,37,12,25,45,107,159,1,Matches
Adam Lallana,eng ENG,MF,Southampton,36-336,1988,4.0,8,5,4,4,0,2,12,16.7,10,4,1,3,5,13,5,0,Matches
Tariq Lamptey,gh GHA,DF,Brighton,24-193,2000,8.5,14,10,8,6,0,7,22,31.8,15,12,5,7,6,20,21,1,Matches
Will Lankshear,eng ENG,"FW,MF",Tottenham,19-356,2005,0.1,0,0,0,0,0,0,0,,0,0,0,0,0,0,0,0,Matches
Roméo Lavia,be BEL,MF,Chelsea,21-095,2004,6.0,17,10,5,9,3,7,14,50.0,7,6,0,6,11,28,5,0,Matches
Mario Lemina,ga GAB,"MF,DF",Wolves,31-222,1993,15.2,51,31,27,19,5,20,29,69.0,9,12,7,5,27,78,50,3,Matches
Bernd Leno,de GER,GK,Fulham,33-038,1992,31.0,2,2,2,0,0,2,2,100.0,0,1,0,1,0,2,7,4,Matches
Jefferson Lerma,co COL,"MF,DF",Crystal Palace,30-168,1994,19.1,25,11,9,12,4,13,28,46.4,15,28,15,13,31,56,49,1,Matches
Rico Lewis,eng ENG,"DF,MF",Manchester City,20-141,2004,19.1,29,19,13,12,4,13,21,61.9,8,26,7,19,12,41,42,1,Matches
Keane Lewis-Potter,eng ENG,"DF,FW",Brentford,24-048,2001,28.3,43,25,22,15,6,26,41,63.4,15,24,9,15,17,60,63,3,Matches
Myles Lewis-Skelly,eng ENG,DF,Arsenal,18-197,2006,10.3,21,14,10,9,2,9,9,100.0,0,1,0,1,5,26,16,0,Matches
Matthijs de Ligt,nl NED,DF,Manchester Utd,25-242,1999,23.2,30,22,17,12,1,23,32,71.9,9,29,21,8,33,63,92,0,Matches
Pedro Lima,br BRA,DF,Wolves,18-284,2006,0.8,1,0,0,0,1,1,3,33.3,2,0,0,0,2,3,5,0,Matches
Victor Lindelöf,se SWE,DF,Manchester Utd,30-268,1994,3.1,4,0,4,0,0,1,2,50.0,1,2,1,1,4,8,24,1,Matches
Jesper Lindstrøm,dk DEN,FW,Everton,25-041,2000,13.8,45,25,24,19,2,19,55,34.5,36,15,3,12,12,57,17,0,Matches
Valentino Livramento,eng ENG,DF,Newcastle Utd,22-150,2002,23.6,45,30,31,11,3,26,44,59.1,18,28,9,19,20,65,87,1,Matches
Sean Longstaff,eng ENG,MF,Newcastle Utd,27-163,1997,8.6,27,16,10,9,8,18,27,66.7,9,15,4,11,6,33,6,0,Matches
Saša Lukić,rs SRB,MF,Fulham,28-241,1996,20.9,56,31,15,36,5,16,45,35.6,29,16,6,10,22,78,29,0,Matches
Joe Lumley,eng ENG,GK,Southampton,30-055,1995,3.0,0,0,0,0,0,0,0,,0,0,0,0,0,0,3,3,Matches
Massimo Luongo,au AUS,MF,Ipswich Town,32-198,1992,2.0,8,5,6,1,1,4,7,57.1,3,4,2,2,2,10,2,0,Matches
Ian Maatsen,nl NED,DF,Aston Villa,23-032,2002,7.9,18,9,10,6,2,10,16,62.5,6,6,0,6,10,28,26,2,Matches
Alexis Mac Allister,ar ARG,MF,Liverpool,26-108,1998,25.5,82,50,22,48,12,46,87,52.9,41,54,5,49,19,101,25,1,Matches
James Maddison,eng ENG,MF,Tottenham,28-139,1996,18.8,29,18,8,14,7,9,27,33.3,18,15,4,11,11,40,19,1,Matches
Noni Madueke,eng ENG,FW,Chelsea,23-032,2002,17.0,17,12,7,9,1,11,31,35.5,20,12,0,12,8,25,10,0,Matches
Gabriel Magalhães,br BRA,DF,Arsenal,27-113,1997,26.3,25,15,12,8,5,12,16,75.0,4,42,29,13,16,41,93,2,Matches
Edmond-Paris Maghoma,eng ENG,"MF,FW",Brentford,23-338,2001,1.3,2,1,0,2,0,1,3,33.3,2,2,2,0,1,3,2,0,Matches
Harry Maguire,eng ENG,DF,Manchester Utd,32-037,1993,15.8,26,13,20,5,1,13,17,76.5,4,14,12,2,36,62,70,1,Matches
Kobbie Mainoo,eng ENG,MF,Manchester Utd,19-357,2005,14.3,37,24,15,11,11,20,33,60.6,13,15,2,13,17,54,6,1,Matches
Tyrell Malacia,nl NED,DF,Manchester Utd,25-237,1999,1.1,2,1,2,0,0,1,2,50.0,1,0,0,0,1,3,1,1,Matches
Donyell Malen,nl NED,FW,Aston Villa,26-092,1999,2.6,6,3,3,2,1,1,4,25.0,3,0,0,0,0,6,0,0,Matches
Orel Mangala,be BEL,MF,Everton,27-024,1998,14.0,16,8,3,11,2,5,8,62.5,3,8,3,5,21,37,24,1,Matches
Ryan Manning,ie IRL,DF,Southampton,28-301,1996,12.4,26,16,15,9,2,13,23,56.5,10,18,11,7,15,41,33,0,Matches
Solly March,eng ENG,"MF,FW",Brighton,30-265,1994,0.7,6,3,2,2,2,5,6,83.3,1,3,0,3,1,7,0,0,Matches
Omar Marmoush,eg EGY,"FW,MF",Manchester City,26-063,1999,7.3,11,6,2,7,2,7,13,53.8,6,8,1,7,5,16,3,0,Matches
Gabriel Martinelli,br BRA,"FW,MF",Arsenal,23-297,2001,18.9,19,14,7,5,7,6,20,30.0,14,10,0,10,3,22,14,0,Matches
Emiliano Martínez,ar ARG,GK,Aston Villa,32-221,1992,29.0,2,2,2,0,0,1,1,100.0,0,1,0,1,0,2,14,6,Matches
Lisandro Martínez,ar ARG,DF,Manchester Utd,27-083,1998,19.5,40,24,25,12,3,21,36,58.3,15,22,8,14,32,72,57,1,Matches
Pape Matar Sarr,sn SEN,MF,Tottenham,22-209,2002,16.2,41,29,16,21,4,10,21,47.6,11,21,7,14,22,63,17,1,Matches
Jean-Philippe Mateta,fr FRA,FW,Crystal Palace,27-287,1997,25.1,17,12,4,11,2,3,15,20.0,12,14,3,11,2,19,20,0,Matches
Stephy Mavididi,eng ENG,FW,Leicester City,26-315,1998,16.0,30,16,15,9,6,11,37,29.7,26,23,2,21,11,41,13,0,Matches
Konstantinos Mavropanos,gr GRE,DF,West Ham,27-121,1997,19.5,32,22,22,9,1,14,25,56.0,11,20,15,5,37,69,102,1,Matches
Noussair Mazraoui,ma MAR,DF,Manchester Utd,27-148,1997,26.6,92,55,45,34,13,45,78,57.7,33,29,7,22,33,125,80,0,Matches
Bryan Mbeumo,cm CMR,FW,Brentford,25-247,1999,30.9,34,20,13,11,10,13,22,59.1,9,21,3,18,13,47,42,1,Matches
James Mcatee,eng ENG,"MF,FW",Manchester City,22-175,2002,1.6,3,2,0,3,0,0,4,0.0,4,4,0,4,1,4,0,0,Matches
Kasey McAteer,ie IRL,"FW,MF",Leicester City,23-140,2001,4.4,11,8,6,4,1,6,14,42.9,8,8,1,7,2,13,10,0,Matches
Alex McCarthy,eng ENG,GK,Southampton,35-129,1989,5.0,0,0,0,0,0,0,0,,0,0,0,0,0,0,1,4,Matches
John McGinn,sct SCO,"MF,FW",Aston Villa,30-175,1994,20.9,27,18,8,13,6,10,21,47.6,11,16,1,15,11,38,12,3,Matches
Dwight McNeil,eng ENG,"MF,FW",Everton,25-140,1999,12.7,10,6,5,3,2,7,16,43.8,9,7,0,7,5,15,1,1,Matches
Scott McTominay,sct SCO,MF,Manchester Utd,28-124,1996,0.2,0,0,0,0,0,0,1,0.0,1,0,0,0,0,0,1,0,Matches
Ben Mee,eng ENG,DF,Brentford,35-202,1989,2.0,2,2,0,2,0,1,1,100.0,0,3,3,0,4,6,7,0,Matches
Jayden Meghoma,eng ENG,DF,Brentford,18-287,2006,0.1,0,0,0,0,0,0,0,,0,0,0,0,0,0,0,0,Matches
Mikel Merino,es ESP,"MF,FW",Arsenal,28-293,1996,14.8,32,18,5,20,7,12,26,46.2,14,17,5,12,13,45,23,1,Matches
Shumaira Mheuka,eng ENG,MF,Chelsea,17-173,2007,0.0,0,0,0,0,0,0,0,,0,0,0,0,0,0,0,0,Matches
Nikola Milenković,rs SRB,DF,Nott'ham Forest,27-181,1997,30.0,39,24,26,11,2,19,25,76.0,6,36,21,15,21,60,155,1,Matches
Lewis Miley,eng ENG,MF,Newcastle Utd,18-345,2006,2.4,9,7,4,5,0,5,10,50.0,5,5,1,4,2,11,5,2,Matches
James Milner,eng ENG,MF,Brighton,39-097,1986,1.9,5,2,1,3,1,3,3,100.0,0,4,2,2,2,7,2,1,Matches
Tyrone Mings,eng ENG,DF,Aston Villa,32-029,1993,9.7,6,5,5,1,0,2,2,100.0,0,13,11,2,5,11,48,1,Matches
Yankuba Minteh,gm GAM,"FW,MF",Brighton,20-263,2004,14.9,38,28,21,10,7,16,43,37.2,27,16,0,16,10,48,25,0,Matches
Tyrick Mitchell,eng ENG,DF,Crystal Palace,25-222,1999,28.0,77,49,49,23,5,21,39,53.8,18,54,10,44,13,90,83,2,Matches
Kaoru Mitoma,jp JPN,"FW,MF",Brighton,27-326,1997,27.4,41,24,13,13,15,17,44,38.6,27,45,3,42,13,54,9,0,Matches
Jakub Moder,pl POL,MF,Brighton,26-004,1999,0.1,1,0,1,0,0,0,2,0.0,2,0,0,0,0,1,3,0,Matches
Jeremy Monga,,FW,Leicester City,,,0.2,0,0,0,0,0,0,0,,0,0,0,0,0,0,0,0,Matches
Mikey Moore,eng ENG,"FW,MF",Tottenham,17-243,2007,2.1,0,0,0,0,0,0,1,0.0,1,1,0,1,1,1,1,0,Matches
Morato,br BRA,DF,Nott'ham Forest,23-285,2001,8.4,21,13,18,2,1,13,20,65.0,7,11,4,7,9,30,66,2,Matches
Álex Moreno,es ESP,"DF,MF",Nott'ham Forest,31-307,1993,9.6,24,18,19,5,0,14,37,37.8,23,11,5,6,14,38,37,0,Matches
Sam Morsy,eg EGY,MF,Ipswich Town,33-213,1991,23.9,55,31,29,22,4,23,54,42.6,31,24,9,15,25,80,37,4,Matches
Yerson Mosquera,co COL,DF,Wolves,23-344,2001,4.9,11,7,9,2,0,9,14,64.3,5,13,10,3,10,21,14,0,Matches
Mason Mount,eng ENG,"MF,FW",Manchester Utd,26-091,1999,3.1,7,2,3,4,0,6,8,75.0,2,5,1,4,2,9,0,0,Matches
Divin Mubama,eng ENG,FW,Manchester City,20-168,2004,0.3,0,0,0,0,0,0,0,,0,0,0,0,0,0,0,0,Matches
Mykhailo Mudryk,ua UKR,FW,Chelsea,24-096,2001,1.7,2,2,2,0,0,0,0,,0,3,1,2,0,2,1,0,Matches
Marshall Munetsi,zw ZIM,"MF,FW",Wolves,28-293,1996,5.8,16,7,4,7,5,9,13,69.2,4,5,1,4,3,19,12,0,Matches
Rodrigo Muniz,br BRA,FW,Fulham,23-342,2001,10.1,10,5,3,5,2,4,4,100.0,0,9,2,7,5,15,12,0,Matches
Daniel Muñoz,co COL,DF,Crystal Palace,28-320,1996,27.9,97,64,47,31,19,42,74,56.8,32,28,2,26,31,128,82,1,Matches
Arijanet Muric,xk KVX,GK,Ipswich Town,26-155,1998,18.0,0,0,0,0,0,0,2,0.0,2,0,0,0,0,0,10,5,Matches
Murillo,br BRA,DF,Nott'ham Forest,22-281,2002,29.5,44,32,30,11,3,23,39,59.0,16,63,41,22,29,73,196,2,Matches
Jacob Murphy,eng ENG,FW,Newcastle Utd,30-046,1995,20.2,20,13,7,8,5,15,28,53.6,13,30,0,30,11,31,21,1,Matches
Vitaliy Mykolenko,ua UKR,DF,Everton,25-317,1999,27.2,52,31,31,13,8,24,45,53.3,21,22,9,13,32,84,123,1,Matches
Iliman Ndiaye,sn SEN,FW,Everton,25-036,2000,21.9,46,24,18,14,14,19,44,43.2,25,23,4,19,17,63,22,1,Matches
Wilfred Ndidi,ng NGA,MF,Leicester City,28-116,1996,20.3,66,38,38,25,3,21,44,47.7,23,37,15,22,22,88,66,0,Matches
Kosta Nedeljković,rs SRB,DF,Aston Villa,19-116,2005,1.4,7,5,1,3,3,2,3,66.7,1,1,0,1,0,7,3,0,Matches
Reiss Nelson,eng ENG,FW,Arsenal,25-122,1999,0.0,1,0,0,1,0,0,1,0.0,1,0,0,0,0,1,1,0,Matches
Reiss Nelson,eng ENG,FW,Fulham,25-122,1999,5.4,8,6,3,3,2,5,13,38.5,8,11,0,11,5,13,2,0,Matches
Neto,br BRA,GK,Bournemouth,35-266,1989,2.0,0,0,0,0,0,0,0,,0,0,0,0,0,0,1,1,Matches
Pedro Neto,pt POR,FW,Chelsea,25-033,2000,18.4,17,9,6,8,3,6,16,37.5,10,11,1,10,7,24,3,0,Matches
Eddie Nketiah,eng ENG,"FW,MF",Crystal Palace,25-316,1999,8.3,12,5,6,2,4,5,11,45.5,6,9,0,9,2,14,9,0,Matches
Christopher Nkunku,fr FRA,FW,Chelsea,27-148,1997,10.2,12,8,3,4,5,6,8,75.0,2,9,2,7,7,19,10,0,Matches
Matheus Nunes,pt POR,"DF,MF",Manchester City,26-227,1998,13.6,26,17,11,9,6,12,26,46.2,14,12,3,9,12,38,25,0,Matches
Darwin Núñez,uy URU,FW,Liverpool,25-291,1999,11.2,18,15,10,3,5,5,15,33.3,10,6,0,6,3,21,12,0,Matches
Ethan Nwaneri,eng ENG,"FW,MF",Arsenal,18-021,2007,8.0,10,7,4,3,3,6,16,37.5,10,8,2,6,1,11,4,1,Matches
Christian Nørgaard,dk DEN,MF,Brentford,31-032,1994,24.3,71,44,32,32,7,41,64,64.1,23,40,15,25,38,109,54,1,Matches
Jake O'Brien,ie IRL,DF,Everton,23-331,2001,11.5,19,13,16,3,0,13,17,76.5,4,12,3,9,3,22,67,0,Matches
Matt O'Riley,dk DEN,MF,Brighton,24-141,2000,6.0,15,9,4,8,3,4,11,36.4,7,6,3,3,11,26,5,1,Matches
Dara O'Shea,ie IRL,DF,Ipswich Town,26-038,1999,27.7,40,25,26,11,3,17,27,63.0,10,53,43,10,30,70,172,4,Matches
Chidozie Obi-Martin,dk DEN,FW,Manchester Utd,17-133,2007,0.3,0,0,0,0,0,0,0,,0,0,0,0,0,0,1,0,Matches
Wilson Odobert,fr FRA,FW,Tottenham,20-134,2004,5.0,6,2,2,3,1,4,9,44.4,5,4,0,4,2,8,2,1,Matches
Chiedozie Ogbene,ie IRL,FW,Ipswich Town,27-345,1997,2.6,7,3,1,2,4,2,4,50.0,2,1,0,1,1,8,3,0,Matches
Caleb Okoli,it ITA,DF,Leicester City,23-272,2001,11.5,24,13,8,14,2,10,17,58.8,7,22,12,10,14,38,73,2,Matches
Robin Olsen,se SWE,GK,Aston Villa,35-093,1990,2.0,1,0,1,0,0,1,1,100.0,0,0,0,0,0,1,2,1,Matches
Amadou Onana,be BEL,MF,Aston Villa,23-238,2001,13.0,39,22,18,18,3,12,22,54.5,10,13,6,7,20,59,27,3,Matches
André Onana,cm CMR,GK,Manchester Utd,29-009,1996,31.0,1,1,1,0,0,1,3,33.3,2,0,0,0,0,1,11,4,Matches
Paul Onuachu,ng NGA,FW,Southampton,30-318,1994,9.7,7,2,1,5,1,3,7,42.9,4,6,1,5,1,8,12,1,Matches
Frank Onyeka,ng NGA,MF,Brentford,27-100,1998,0.3,0,0,0,0,0,0,0,,0,0,0,0,0,0,0,0,Matches
Lewis Orford,eng ENG,MF,West Ham,19-052,2006,0.5,0,0,0,0,0,0,0,,0,1,0,1,1,1,0,0,Matches
Stefan Ortega,de GER,GK,Manchester City,32-156,1992,10.0,0,0,0,0,0,0,1,0.0,1,0,0,0,0,0,10,1,Matches
William Osula,dk DEN,FW,Newcastle Utd,21-250,2003,1.0,1,0,0,0,1,0,1,0.0,1,0,0,0,4,5,2,0,Matches
Dango Ouattara,bf BFA,FW,Bournemouth,23-059,2002,18.7,31,23,11,11,9,16,36,44.4,20,30,8,22,8,39,42,0,Matches
Nico O’Reilly,eng ENG,"DF,MF",Manchester City,20-021,2005,2.1,4,1,0,2,2,1,3,33.3,2,0,0,0,2,6,5,0,Matches
Alex Palmer,eng ENG,GK,Ipswich Town,28-244,1996,7.0,0,0,0,0,0,0,0,,0,0,0,0,0,0,6,0,Matches
Cole Palmer,eng ENG,MF,Chelsea,22-340,2002,28.5,24,15,11,7,6,8,21,38.1,13,14,1,13,7,31,15,1,Matches
Emerson Palmieri,it ITA,DF,West Ham,30-251,1994,20.6,53,28,32,17,4,21,39,53.8,18,30,7,23,18,71,51,0,Matches
Lucas Paquetá,br BRA,"MF,FW",West Ham,27-227,1997,22.1,59,34,22,28,9,22,45,48.9,23,24,3,21,16,75,27,3,Matches
Thomas Partey,gh GHA,"MF,DF",Arsenal,31-302,1993,25.3,79,48,23,36,20,43,67,64.2,24,21,6,15,29,108,41,4,Matches
Nathan Patterson,sct SCO,"DF,FW",Everton,23-177,2001,2.3,4,1,2,2,0,2,6,33.3,4,2,0,2,0,4,4,0,Matches
Andreas Pereira,br BRA,MF,Fulham,29-100,1996,18.6,22,12,7,11,4,10,37,27.0,27,15,2,13,8,30,14,2,Matches
Ricardo Pereira,pt POR,DF,Leicester City,31-187,1993,2.1,5,2,1,1,3,2,7,28.6,5,4,1,3,1,6,4,0,Matches
Kalvin Phillips,eng ENG,MF,Ipswich Town,29-130,1995,13.5,34,19,8,19,7,15,38,39.5,23,35,6,29,19,53,37,2,Matches
Jaden Philogene Bidace,eng ENG,"FW,MF",Aston Villa,23-062,2002,3.7,11,5,4,7,0,4,6,66.7,2,5,0,5,3,14,2,1,Matches
Jaden Philogene Bidace,eng ENG,"FW,DF",Ipswich Town,23-062,2002,5.2,14,7,6,6,2,8,15,53.3,7,10,1,9,10,24,9,1,Matches
Jordan Pickford,eng ENG,GK,Everton,31-035,1994,31.0,1,0,1,0,0,1,2,50.0,1,0,0,0,1,2,28,1,Matches
Ethan Pinnock,jm JAM,DF,Brentford,31-317,1993,21.3,35,19,15,16,4,13,24,54.2,11,29,18,11,24,59,142,4,Matches
Daniel Podence,pt POR,"MF,FW",Wolves,29-172,1995,0.5,0,0,0,0,0,0,1,0.0,1,0,0,0,0,0,0,0,Matches
Alfie Pond,eng ENG,DF,Wolves,21-041,2004,0.0,0,0,0,0,0,0,0,,0,0,0,0,0,0,0,0,Matches
Nick Pope,eng ENG,GK,Newcastle Utd,32-357,1992,20.0,0,0,0,0,0,0,0,,0,1,0,1,1,1,24,5,Matches
Pedro Porro,es ESP,DF,Tottenham,25-210,1999,26.4,61,44,29,22,10,42,71,59.2,29,42,17,25,33,94,78,1,Matches
Jarell Quansah,eng ENG,DF,Liverpool,22-072,2003,3.2,9,7,7,2,0,4,5,80.0,1,4,4,0,5,14,13,0,Matches
Hákon Rafn Valdimarsson,is ISL,GK,Brentford,23-180,2001,1.6,0,0,0,0,0,0,0,,0,0,0,0,0,0,2,0,Matches
Aaron Ramsdale,eng ENG,GK,Southampton,26-332,1998,23.0,0,0,0,0,0,0,2,0.0,2,0,0,0,2,2,8,2,Matches
Jacob Ramsey,eng ENG,"FW,MF",Aston Villa,23-318,2001,14.9,24,13,12,9,3,8,16,50.0,8,19,3,16,7,31,7,1,Matches
Marcus Rashford,eng ENG,"FW,MF",Manchester Utd,27-162,1997,10.9,7,4,2,2,3,3,9,33.3,6,8,0,8,4,11,7,0,Matches
Marcus Rashford,eng ENG,FW,Aston Villa,27-162,1997,3.3,6,3,0,1,5,2,3,66.7,1,2,0,2,1,7,3,0,Matches
David Raya,es ESP,GK,Arsenal,29-208,1995,31.0,0,0,0,0,0,0,2,0.0,2,0,0,0,2,2,17,4,Matches
Harrison Reed,eng ENG,MF,Fulham,30-074,1995,1.0,6,3,3,2,1,1,3,33.3,2,1,0,1,1,7,3,0,Matches
Remy Rees-Dottin,eng ENG,FW,Bournemouth,19-036,2006,0.0,0,0,0,0,0,0,0,,0,0,0,0,0,0,0,0,Matches
Sergio Reguilón,es ESP,DF,Tottenham,28-116,1996,1.4,4,3,1,3,0,2,3,66.7,1,4,0,4,2,6,3,0,Matches
Bobby Reid,jm JAM,"FW,MF",Leicester City,32-068,1993,7.1,8,3,3,5,0,3,13,23.1,10,6,1,5,0,8,8,0,Matches
Vitor Reis,br BRA,DF,Manchester City,19-089,2006,0.0,0,0,0,0,0,0,0,,0,0,0,0,0,0,1,0,Matches
Chadi Riad,ma MAR,DF,Crystal Palace,21-298,2003,1.0,5,2,2,2,1,2,3,66.7,1,0,0,0,2,7,0,0,Matches
Declan Rice,eng ENG,MF,Arsenal,26-087,1999,26.0,46,19,20,20,6,15,35,42.9,20,21,10,11,22,68,40,0,Matches
Chris Richards,us USA,DF,Crystal Palace,25-014,2000,14.9,38,25,17,16,5,21,34,61.8,13,26,9,17,9,47,83,0,Matches
Richarlison,br BRA,FW,Tottenham,27-336,1997,3.1,4,3,0,3,1,0,0,,0,1,1,0,0,4,8,0,Matches
Andrew Robertson,sct SCO,DF,Liverpool,31-031,1994,24.3,38,22,24,10,4,30,47,63.8,17,9,4,5,20,58,49,2,Matches
Antonee Robinson,us USA,DF,Fulham,27-246,1997,30.2,82,54,50,26,6,43,82,52.4,39,34,5,29,53,135,109,0,Matches
Rodri,es ESP,MF,Manchester City,28-293,1996,0.7,2,1,1,1,0,0,0,,0,1,0,1,1,3,0,0,Matches
Guido Rodríguez,ar ARG,MF,West Ham,30-364,1994,11.3,30,16,19,11,0,14,30,46.7,16,21,9,12,12,42,28,1,Matches
Mads Roerslev,dk DEN,DF,Brentford,25-291,1999,12.2,18,8,14,3,1,11,28,39.3,17,12,5,7,4,22,35,0,Matches
Morgan Rogers,eng ENG,"FW,MF",Aston Villa,22-259,2002,27.9,32,16,11,12,9,16,36,44.4,20,22,5,17,5,37,18,2,Matches
Cristian Romero,ar ARG,DF,Tottenham,26-349,1998,14.2,32,26,24,7,1,18,27,66.7,9,17,3,14,19,51,48,1,Matches
Georginio Rutter,fr FRA,"MF,FW",Brighton,22-356,2002,18.4,39,15,13,18,8,14,36,38.9,22,20,3,17,10,49,13,2,Matches
José Sá,pt POR,GK,Wolves,32-084,1993,24.0,2,2,2,0,0,2,2,100.0,0,0,0,0,0,2,14,1,Matches
Bukayo Saka,eng ENG,"FW,MF",Arsenal,23-218,2001,14.9,23,13,6,10,7,10,20,50.0,10,16,0,16,2,25,7,0,Matches
Mohamed Salah,eg EGY,FW,Liverpool,32-300,1992,30.5,20,11,7,5,8,7,14,50.0,7,10,0,10,6,26,5,0,Matches
William Saliba,fr FRA,DF,Arsenal,24-018,2001,28.3,53,31,32,19,2,18,24,75.0,6,21,12,9,19,72,98,5,Matches
Robert Sánchez,es ESP,GK,Chelsea,27-144,1997,25.0,0,0,0,0,0,0,1,0.0,1,0,0,0,2,2,20,8,Matches
Jadon Sancho,eng ENG,FW,Chelsea,25-017,2000,17.6,10,6,3,2,5,5,12,41.7,7,9,0,9,2,12,6,2,Matches
Ibrahim Sangaré,ci CIV,MF,Nott'ham Forest,27-130,1997,3.1,18,10,5,12,1,4,10,40.0,6,5,0,5,2,20,4,0,Matches
Pablo Sarabia,es ESP,"MF,FW",Wolves,32-335,1992,6.8,13,7,4,8,1,8,12,66.7,4,6,0,6,4,17,5,1,Matches
Jeremy Sarmiento,ec ECU,MF,Brighton,22-299,2002,0.1,0,0,0,0,0,0,0,,0,0,0,0,0,0,0,0,Matches
Ismaila Sarr,sn SEN,MF,Crystal Palace,27-045,1998,23.4,19,10,8,8,3,7,22,31.8,15,21,7,14,7,26,31,0,Matches
Sávio,br BRA,"FW,MF",Manchester City,21-001,2004,18.3,21,15,4,10,7,8,17,47.1,9,13,2,11,6,27,7,1,Matches
Oliver Scarles,eng ENG,DF,West Ham,19-120,2005,5.9,15,11,11,3,1,11,17,64.7,6,14,2,12,8,23,18,0,Matches
Dane Scarlett,eng ENG,"FW,MF",Tottenham,21-018,2004,0.4,1,0,0,1,0,0,0,,0,0,0,0,0,1,1,0,Matches
Kevin Schade,de GER,FW,Brentford,23-135,2001,19.5,30,21,12,8,10,11,18,61.1,7,14,2,12,4,34,27,0,Matches
Fabian Schär,ch SUI,DF,Newcastle Utd,33-112,1991,24.8,28,19,14,14,0,11,26,42.3,15,33,21,12,35,63,98,2,Matches
Jeffrey Schlupp,gh GHA,"MF,DF",Crystal Palace,32-109,1992,1.1,2,0,1,0,1,0,3,0.0,3,6,0,6,0,2,2,0,Matches
Alex Scott,eng ENG,MF,Bournemouth,21-233,2003,5.6,23,11,10,7,6,16,29,55.2,13,11,1,10,9,32,8,0,Matches
Matz Sels,be BEL,GK,Nott'ham Forest,33-044,1992,31.0,1,1,1,0,0,1,1,100.0,0,0,0,0,0,1,20,1,Matches
Nélson Semedo,pt POR,DF,Wolves,31-146,1993,25.8,50,29,27,17,6,27,47,57.4,20,27,10,17,18,68,93,2,Matches
Antoine Semenyo,gh GHA,FW,Bournemouth,25-094,2000,29.4,50,32,16,23,11,14,40,35.0,26,54,7,47,7,57,28,1,Matches
Marcos Senesi,ar ARG,DF,Bournemouth,27-336,1997,10.7,35,21,22,11,2,14,28,50.0,14,14,6,8,11,46,49,0,Matches
Ryan Sessegnon,eng ENG,"FW,DF",Fulham,24-328,2000,2.1,6,1,3,2,1,2,5,40.0,3,3,0,3,2,8,3,0,Matches
Luke Shaw,eng ENG,DF,Manchester Utd,29-273,1995,0.8,2,2,1,1,0,1,1,100.0,0,1,0,1,1,3,1,0,Matches
Zain Silcott-Duberry,ms MSR,FW,Bournemouth,19-276,2005,0.0,1,1,0,0,1,1,1,100.0,0,0,0,0,0,1,0,0,Matches
Bernardo Silva,pt POR,"MF,FW",Manchester City,30-244,1994,23.7,47,30,15,24,8,22,46,47.8,24,26,6,20,18,65,21,3,Matches
Jota Silva,pt POR,"FW,MF",Nott'ham Forest,25-253,1999,8.6,22,11,11,9,2,4,24,16.7,20,9,1,8,12,34,15,0,Matches
Eric da Silva Moreira,de GER,"MF,DF",Nott'ham Forest,18-343,2006,0.3,2,2,2,0,0,2,6,33.3,4,0,0,0,1,3,0,0,Matches
Jahmai Simpson-Pusey,eng ENG,DF,Manchester City,19-158,2005,1.1,1,0,1,0,0,0,1,0.0,1,1,1,0,0,1,2,0,Matches
Luis Sinisterra,co COL,"FW,MF",Bournemouth,25-298,1999,2.6,7,2,3,2,2,0,4,0.0,4,3,0,3,1,8,8,0,Matches
Oliver Skipp,eng ENG,MF,Leicester City,24-207,2000,9.2,14,4,4,9,1,6,11,54.5,5,14,3,11,8,22,10,1,Matches
William Smallbone,ie IRL,MF,Southampton,25-049,2000,6.5,16,9,8,6,2,6,18,33.3,12,7,0,7,2,18,12,2,Matches
Adam Smith,eng ENG,DF,Bournemouth,33-347,1991,12.7,18,9,9,4,5,10,21,47.6,11,10,3,7,12,30,38,1,Matches
Emile Smith Rowe,eng ENG,MF,Fulham,24-257,2000,20.1,30,17,7,13,10,8,24,33.3,16,19,2,17,10,40,14,0,Matches
Dominic Solanke,eng ENG,FW,Tottenham,27-209,1997,21.7,18,11,1,12,5,4,11,36.4,7,16,7,9,0,18,22,0,Matches
Carlos Soler,es ESP,"MF,FW",West Ham,28-099,1997,13.1,12,10,7,5,0,5,20,25.0,15,17,4,13,8,20,17,2,Matches
Ramón Sosa,py PAR,"FW,MF",Nott'ham Forest,25-223,1999,2.9,5,3,3,0,2,1,4,25.0,3,7,0,7,3,8,4,0,Matches
Tomáš Souček,cz CZE,MF,West Ham,30-043,1995,23.9,36,18,15,18,3,17,34,50.0,17,33,16,17,14,50,72,1,Matches
Boubakary Soumaré,fr FRA,MF,Leicester City,26-043,1999,19.2,30,15,20,9,1,16,27,59.3,11,14,6,8,23,53,22,3,Matches
Djed Spence,eng ENG,DF,Tottenham,24-245,2000,13.8,35,26,20,10,5,18,23,78.3,5,21,8,13,16,51,48,1,Matches
Jay Stansfield,eng ENG,MF,Fulham,22-138,2002,0.0,0,0,0,0,0,0,0,,0,0,0,0,0,0,0,0,Matches
Jason Steele,eng ENG,GK,Brighton,34-236,1990,2.0,0,0,0,0,0,0,0,,0,0,0,0,0,0,1,0,Matches
Jack Stephens,eng ENG,DF,Southampton,31-074,1994,9.9,16,10,13,3,0,6,16,37.5,10,8,6,2,9,25,35,2,Matches
Raheem Sterling,eng ENG,"FW,MF",Arsenal,30-124,1994,3.9,7,4,1,2,4,4,6,66.7,2,2,0,2,1,8,2,0,Matches
Ross Stewart,sct SCO,"FW,MF",Southampton,28-274,1996,1.6,0,0,0,0,0,0,4,0.0,4,3,0,3,0,0,4,0,Matches
Jakub Stolarczyk,pl POL,GK,Leicester City,24-113,2000,6.0,2,1,2,0,0,1,2,50.0,1,0,0,0,0,2,5,0,Matches
John Stones,eng ENG,"DF,MF",Manchester City,30-318,1994,6.1,6,2,3,2,1,5,5,100.0,0,5,3,2,4,10,19,1,Matches
Jørgen Strand Larsen,no NOR,FW,Wolves,25-064,2000,24.9,8,5,2,3,3,4,23,17.4,19,17,4,13,4,12,25,0,Matches
Yukinari Sugawara,jp JPN,"DF,MF",Southampton,24-287,2000,16.2,29,16,14,14,1,18,30,60.0,12,17,7,10,10,39,46,3,Matches
Kamaldeen Sulemana,gh GHA,"FW,MF",Southampton,23-055,2002,10.1,13,11,5,3,5,6,11,54.5,5,9,0,9,4,17,5,0,Matches
Crysencio Summerville,nl NED,"FW,MF",West Ham,23-163,2001,8.7,13,7,2,8,3,3,9,33.3,6,13,4,9,0,13,7,0,Matches
Sammie Szmodics,ie IRL,"FW,MF",Ipswich Town,29-199,1995,10.9,15,9,4,9,2,6,23,26.1,17,10,2,8,6,21,14,0,Matches
Dominik Szoboszlai,hu HUN,MF,Liverpool,24-168,2000,23.3,29,19,8,16,5,15,37,40.5,22,33,4,29,9,38,15,2,Matches
Matt Targett,eng ENG,DF,Newcastle Utd,29-205,1995,0.1,0,0,0,0,0,0,1,0.0,1,0,0,0,1,1,1,0,Matches
James Tarkowski,eng ENG,DF,Everton,32-143,1992,30.9,61,38,38,20,3,23,38,60.5,15,56,41,15,39,100,202,4,Matches
Marcus Tavernier,eng ENG,"FW,MF",Bournemouth,26-020,1999,16.7,38,23,12,17,9,9,25,36.0,16,12,2,10,4,42,11,0,Matches
Charlie Taylor,eng ENG,DF,Southampton,31-205,1993,3.0,7,5,4,3,0,5,6,83.3,1,5,3,2,3,10,22,1,Matches
Jack Taylor,ie IRL,MF,Ipswich Town,26-292,1998,6.0,15,7,4,9,2,9,17,52.9,8,5,2,3,4,19,16,0,Matches
Mathys Tel,fr FRA,FW,Tottenham,19-349,2005,3.5,2,1,0,1,1,1,6,16.7,5,2,0,2,0,2,1,1,Matches
Kenny Tete,nl NED,DF,Fulham,29-184,1995,14.1,41,27,20,12,9,17,28,60.7,11,19,6,13,28,69,37,0,Matches
Thiago,br BRA,FW,Brentford,23-289,2001,1.5,2,2,1,0,1,0,1,0.0,1,0,0,0,2,4,2,1,Matches
Luke Thomas,eng ENG,DF,Leicester City,23-305,2001,6.0,18,14,16,1,1,15,22,68.2,7,9,4,5,7,25,24,1,Matches
Youri Tielemans,be BEL,MF,Aston Villa,27-339,1997,29.4,75,50,28,40,7,36,66,54.5,30,35,15,20,21,96,41,3,Matches
Kieran Tierney,sct SCO,"DF,FW",Arsenal,27-310,1997,1.1,3,2,1,1,1,1,3,33.3,2,0,0,0,1,4,2,0,Matches
Jurriën Timber,nl NED,DF,Arsenal,23-298,2001,25.6,57,37,16,30,11,17,26,65.4,9,19,4,15,21,78,44,1,Matches
Jean-Clair Todibo,fr FRA,DF,West Ham,25-102,1999,13.6,31,19,21,10,0,19,22,86.4,3,19,10,9,19,50,61,3,Matches
Harry Toffolo,eng ENG,DF,Nott'ham Forest,29-235,1995,0.5,2,0,1,0,1,0,0,,0,0,0,0,1,3,7,0,Matches
Takehiro Tomiyasu,jp JPN,DF,Arsenal,26-157,1998,0.1,0,0,0,0,0,0,0,,0,0,0,0,0,0,1,0,Matches
Sandro Tonali,it ITA,MF,Newcastle Utd,24-338,2000,21.2,42,28,17,22,3,20,40,50.0,20,25,10,15,26,68,27,1,Matches
Pau Torres,es ESP,DF,Aston Villa,28-085,1997,18.2,20,14,11,7,2,9,15,60.0,6,14,10,4,9,29,58,2,Matches
Conor Townsend,eng ENG,DF,Ipswich Town,32-038,1993,3.4,10,7,9,1,0,8,11,72.7,3,8,6,2,4,14,12,0,Matches
Adama Traoré,es ESP,"FW,MF",Fulham,29-076,1996,16.5,15,10,8,2,5,5,13,38.5,8,6,0,6,1,16,5,3,Matches
Boubacar Traoré,ml MLI,MF,Wolves,23-234,2001,0.0,2,0,0,2,0,1,1,100.0,0,0,0,0,0,2,0,0,Matches
Mark Travers,ie IRL,GK,Bournemouth,25-328,1999,5.0,0,0,0,0,0,0,0,,0,0,0,0,0,0,5,0,Matches
Ryan Trevitt,eng ENG,MF,Brentford,22-030,2003,0.0,1,1,1,0,0,0,0,,0,0,0,0,0,1,0,0,Matches
Kieran Trippier,eng ENG,DF,Newcastle Utd,34-204,1990,9.7,24,16,10,10,4,14,26,53.8,12,5,1,4,11,35,34,0,Matches
Leandro Trossard,be BEL,FW,Arsenal,30-128,1994,22.2,25,16,5,14,6,9,28,32.1,19,25,0,25,9,34,17,0,Matches
Kostas Tsimikas,gr GRE,DF,Liverpool,28-334,1996,5.7,23,14,11,9,3,12,15,80.0,3,5,2,3,7,30,16,0,Matches
Axel Tuanzebe,cd COD,DF,Ipswich Town,27-148,1997,14.1,25,13,16,3,6,13,21,61.9,8,13,6,7,19,44,43,0,Matches
Destiny Udogie,it ITA,DF,Tottenham,22-134,2002,19.4,71,44,38,26,7,32,45,71.1,13,37,5,32,19,90,34,1,Matches
Manuel Ugarte Ribeiro,uy URU,MF,Manchester Utd,24-000,2001,16.0,65,40,26,31,8,22,54,40.7,32,24,3,21,23,88,14,1,Matches
Lesley Ugochukwu,fr FRA,MF,Southampton,21-016,2004,13.1,42,20,12,27,3,14,29,48.3,15,22,6,16,5,47,13,1,Matches
Enes Ünal,tr TUR,"FW,MF",Bournemouth,27-336,1997,3.8,1,0,0,0,1,0,3,0.0,3,1,0,1,0,1,6,0,Matches
Virgil van Dijk,nl NED,DF,Liverpool,33-277,1991,31.0,34,16,16,16,2,11,20,55.0,9,22,12,10,50,84,159,3,Matches
Jamie Vardy,eng ENG,FW,Leicester City,38-090,1987,26.2,18,13,6,7,5,4,11,36.4,7,8,4,4,3,21,20,0,Matches
Renato Veiga,pt POR,"DF,MF",Chelsea,21-256,2003,2.0,9,6,6,3,0,4,12,33.3,8,3,1,2,1,10,2,0,Matches
Joël Veltman,nl NED,DF,Brighton,33-086,1992,18.3,42,28,23,16,3,30,51,58.8,21,22,7,15,18,60,66,0,Matches
Micky van de Ven,nl NED,DF,Tottenham,23-357,2001,10.1,10,6,5,4,1,8,14,57.1,6,9,6,3,9,19,34,1,Matches
Bart Verbruggen,nl NED,GK,Brighton,22-236,2002,29.0,0,0,0,0,0,0,2,0.0,2,1,0,1,0,0,22,4,Matches
Jannik Vestergaard,dk DEN,DF,Leicester City,32-251,1992,15.5,22,10,16,6,0,9,15,60.0,6,21,14,7,16,38,74,1,Matches
Guglielmo Vicario,it ITA,GK,Tottenham,28-186,1996,19.0,0,0,0,0,0,0,0,,0,0,0,0,1,1,12,2,Matches
Carlos Vinícius,br BRA,MF,Fulham,30-017,1995,0.0,0,0,0,0,0,0,0,,0,0,0,0,0,0,0,0,Matches
Kyle Walker,eng ENG,DF,Manchester City,34-318,1990,10.8,17,10,7,7,3,14,26,53.8,12,13,4,9,3,20,13,1,Matches
Kyle Walker-Peters,eng ENG,DF,Southampton,27-363,1997,28.4,42,27,22,14,6,16,33,48.5,17,25,14,11,16,58,75,1,Matches
Christian Walton,eng ENG,GK,Ipswich Town,29-153,1995,6.0,0,0,0,0,0,0,1,0.0,1,0,0,0,0,0,1,1,Matches
Aaron Wan-Bissaka,eng ENG,DF,West Ham,27-136,1997,29.0,60,42,29,26,5,18,25,72.0,7,30,8,22,52,112,107,0,Matches
Danny Ward,wls WAL,GK,Leicester City,31-293,1993,1.5,0,0,0,0,0,0,0,,0,0,0,0,0,0,1,0,Matches
Joel Ward,eng ENG,DF,Crystal Palace,35-164,1989,0.0,0,0,0,0,0,0,0,,0,0,0,0,0,0,0,0,Matches
James Ward-Prowse,eng ENG,MF,West Ham,30-161,1994,6.5,11,8,6,2,3,3,10,30.0,7,6,3,3,5,16,9,0,Matches
James Ward-Prowse,eng ENG,MF,Nott'ham Forest,30-161,1994,4.4,4,1,1,3,0,2,2,100.0,0,3,2,1,5,9,8,0,Matches
Ollie Watkins,eng ENG,FW,Aston Villa,29-102,1995,23.8,7,5,0,4,3,2,9,22.2,7,11,3,8,6,13,14,2,Matches
Adam Webster,eng ENG,DF,Brighton,30-097,1995,6.9,8,5,4,3,1,5,11,45.5,6,12,9,3,14,22,28,1,Matches
Danny Welbeck,eng ENG,FW,Brighton,34-136,1990,17.7,18,11,5,11,2,4,13,30.8,9,14,1,13,5,23,9,0,Matches
Welington,br BRA,"DF,MF",Southampton,24-051,2001,2.3,12,4,8,3,1,7,11,63.6,4,3,1,2,3,15,12,0,Matches
Timo Werner,de GER,"FW,MF",Tottenham,29-036,1996,5.7,6,4,3,3,0,3,13,23.1,10,10,1,9,1,7,7,0,Matches
Adam Wharton,eng ENG,MF,Crystal Palace,20-313,2004,11.2,33,14,13,16,4,16,39,41.0,23,9,1,8,16,49,22,0,Matches
Ben White,eng ENG,DF,Arsenal,27-185,1997,8.5,11,7,9,1,1,9,22,40.9,13,7,6,1,12,23,28,0,Matches
Mats Wieffer,nl NED,MF,Brighton,25-146,1999,5.7,24,12,6,15,3,10,18,55.6,8,11,1,10,8,32,13,2,Matches
Neco Williams,wls WAL,DF,Nott'ham Forest,23-363,2001,21.8,64,37,49,11,4,37,61,60.7,24,34,6,28,23,87,98,1,Matches
Willian,br BRA,"MF,FW",Fulham,36-245,1988,1.7,1,1,0,1,0,1,3,33.3,2,0,0,0,1,2,1,0,Matches
Joe Willock,eng ENG,"MF,FW",Newcastle Utd,25-234,1999,9.4,21,12,12,6,3,17,26,65.4,9,19,3,16,5,26,7,0,Matches
Callum Wilson,eng ENG,FW,Newcastle Utd,33-043,1992,2.3,2,2,0,1,1,0,2,0.0,2,2,0,2,1,3,1,0,Matches
Harry Wilson,wls WAL,"FW,MF",Fulham,28-020,1997,9.3,10,6,6,3,1,6,11,54.5,5,13,1,12,5,15,5,1,Matches
Harry Winks,eng ENG,MF,Leicester City,29-068,1996,17.1,24,11,12,10,2,13,30,43.3,17,19,7,12,9,33,20,0,Matches
Ben Winterburn,eng ENG,"FW,MF",Bournemouth,20-219,2004,0.3,0,0,0,0,0,0,1,0.0,1,0,0,0,2,2,0,0,Matches
Yoane Wissa,cd COD,FW,Brentford,28-220,1996,25.4,16,7,6,3,7,8,17,47.1,9,25,5,20,7,23,18,3,Matches
Chris Wood,nz NZL,FW,Nott'ham Forest,33-125,1991,26.0,4,4,1,1,2,1,8,12.5,7,11,7,4,4,8,18,1,Matches
Nathan Wood-Gordon,eng ENG,DF,Southampton,22-315,2002,6.9,10,7,6,3,1,5,8,62.5,3,8,5,3,4,14,26,2,Matches
Luke Woolfenden,eng ENG,DF,Ipswich Town,26-172,1998,11.2,9,6,5,4,0,2,5,40.0,3,17,11,6,18,27,60,0,Matches
Yehor Yarmoliuk,ua UKR,MF,Brentford,21-041,2004,10.5,31,20,12,13,6,19,40,47.5,21,23,6,17,9,40,25,0,Matches
Ryan Yates,eng ENG,MF,Nott'ham Forest,27-141,1997,19.2,39,21,22,13,4,16,35,45.7,19,32,8,24,24,63,55,1,Matches
Leny Yoro,fr FRA,DF,Manchester Utd,19-149,2005,9.7,21,10,14,6,1,8,14,57.1,6,5,3,2,16,37,29,0,Matches
Ashley Young,eng ENG,"DF,FW",Everton,39-276,1985,17.6,50,28,22,21,7,31,49,63.3,18,10,3,7,22,72,58,1,Matches
Illia Zabarnyi,ua UKR,DF,Bournemouth,22-222,2002,28.1,44,30,24,19,1,29,42,69.0,13,32,19,13,32,76,141,2,Matches
Oleksandr Zinchenko,ua UKR,"DF,MF",Arsenal,28-117,1996,3.3,2,0,1,1,0,1,4,25.0,3,5,0,5,3,5,5,0,Matches
Joshua Zirkzee,nl NED,"FW,MF",Manchester Utd,23-324,2001,15.0,14,8,3,8,3,5,10,50.0,5,15,4,11,6,20,8,0,Matches
Martin Ødegaard,no NOR,MF,Arsenal,26-115,1998,20.4,18,10,8,7,3,4,23,17.4,19,4,0,4,3,21,4,0,Matches
